000000000000000
000000001000000
000000011000000
000000000000000
000000000000000
000000000000000
000111000100111
000000000100000
000000000100000
000000000000000
111111000000111
100000000001000
100000000000000
100000000000000
000000000000000
000000010001000
000000100000111
000001000000000
000010000000000
000000000000000