000000100000000
000000000001000
000000000000000
010000000000000
000000000000000
000000000000000
110000001000000
000001100000000
000000000011000
000000000000000
110000100000011
100001100000000
000000000011000
000000000000000
000000000000000
000000000000000
001000000000000
000000000000000
000010000000000
000000000000000