000010000100000
000010000000000
000000000000000
000000000000000
000000000111000
000100000000000
000100000000000
000100000000000
000100000000000
000100000001000
000100000001000
000000000001000
000000000001000
000000000001000
000000000001000
000111000000000
000000000000000
000000000000000
000000000000000
000001110000000