000000000000000
000010000000000
000000000000000
000000010000000
000000000000000
000000000000010
000000000000000
000011111100000
000011111100000
000000000000000
000000000000000
000000000000000
111000000000000
000000000000000
000000001000000
000000001000000
000000001000000
000000000000100
000000000000000
000000000000000