000000000000000
000000000000000
000100000000000
000000001000000
000000000000010
000000000000000
000100000000000
000100001000000
000000001000000
000000010000010
000000010000000
000000000000000
100000000000000
000000000000000
000000000000001
000000000100000
000010000000001
000000000100000
000010000000000
000000000000000