000000000000000
000000000000000
000000000000000
000000000000000
111100010000000
000000001000000
000000000100000
000000000000000
000000000000001
111100000000001
000000000000001
000000000000000
000000000000000
000011111100000
000000000000000
000000000000000
000000000000000
000000010000000
000000010000000
000000010000000