000000000000000
000000000000000
000000111000000
000000000000000
000000000000000
000000000001000
111111000000000
000000000000000
000000000000000
000000000011000
000000000000000
000001110000000
000000000000000
000000000000000
110000000000000
000000000001111
000000000000000
000000010000000
000000000000000
000000000000000